0  0  0  0  0  0  0  0  0  0  0  0  0  0  0  0  0  0  0  0  0  0  0  0  0  0  0  0
0  0  0  0  0  0  0  0  0  0  0  0  0  0  0  0  0  0  0  0  0  0  0  0  0  0  0  0
0  0  0  0  0  0  0  0  0  0  0  0  0  0  0  0  0  0  0  0  0  0  0  0  0  0  0  0
0  0  0  0  0  0  0  0  0  0  0  0  0 12 16  0  0  0 13  0  0  0  0  0  0  0  0  0
0  0  0  0  0  0  12 0 14  0  0  0  1  1  1  1  1  1  1  1  0  0  0  0  0  0  0  0
0  0  0  0  8  1  1  1  1  1  1  0  0  0  0  0  0  0  0  0  0  0  0  0  0  1  8  0
0  0  0  0  8  0  0  0  0  0  0  0  0  0  0  0  0  0  0  0  0  1  1  1  1  1  8  0
0  0  0  0  8  0  0  0  0  0  0  0  0  0  0  0  0  0  0  0  0  0  0  0  0  0  8  0
0  0  0  1  1  1  1  0  0  0  0  0 12  0  0  0  0  0  0  0  0  0  0  0  0  0  8  0
0  0  0  0  0  0  0  0  0  0  0  1  1  1  0  0  0  0  0  0  0  0  0  0  0  0  8  0
0  0  0  0  0  0  0  0  0  0  0  0  0  0  0  0  0  0  0  0  0  0  0  0  0  0  8  0
0  0  0  0  0  0  0  0  0  0  0  0  0  0  0  0  0  0  0  0  0  0  0  0  0  0  8  0
0  0  0  0  0  0  0  0  0  0  0  0  0  0  0  0  0  0  0  0  0  0  0  0  0  0  8  0
0 11  0 10  0  0  0  0  0  0  0  0  0  0  0  0  0  0  0  0  0  0  0  0  0  0  8  0
1  1  1  1  1  7  7  7  7  7  7  7  7  7  7  7  7  7  7  7  7  7  1  1  1  1  1  1
1  1  1  1  1  0  0  0  0  0  0  0  0  0  0  0  0  0  0  0  0  0  1  1  1  1  1  1
1  1  1  1  1  0  0  0  0  0  0  0  0  0  0  0  0  0  0  0  0  0  1  1  1  1  1  1