 0  0  0  0  0  0  0  0  0  0  0  0  0  0  0  0  0  0  0  0  0  0  0  0  0  0  0  0
 0  0  0  0  0  0  0  0  0  0  0  0  0  0  0  0  0  0  0  0  0  0  0  0  0  0  0  0
 0  0  0  0  0  0  0  0  0  0  0  0  0  0  0  0  0  0  0  0  0  0  0  0  0  0  0  0
 0  0  0  0  0  0  0  0  0  0  0  0  0  0  0  0  0  0  0  0  0  0  0  0  0  0  0  0
 0  0  0  0  0  0  0  0  0  0  0  0  0  0  0  0  0  0  0  0  0  0  0  0  0  0  0  0
 0  0  0  0  0  8  0  0  0  0  0  0  0  0  0  0  0  0  0  0  0  0  0  0  0  0  0  0
 0  0  0  0  0  8  0  0  0  0  0  0  0  0  0  0  0  0  0  0  0  0  0  0  0  0  0  0
 0  0  0  0  0  8  1  0  0  16  0  0 12 0  0  0  0  0  0  0  19 0  0  0  0  0  0  0
 0  0  0  0  0  8  1  1  1  1  1  1  1  1  0  0  0  0  0  0  19 0  0  0  0  0  0  0
 0  0  0  0  0  8  0  0  0  0  0  0  0  1  1  0  0  0  0  0  19 0  0  0  0  0  0  0
 0  0  0  0  0  8  0  0  0  0  0  0  0  0  0  0  0  0  0  0  19 0  0  0  0  0  0  0
 0  0  0  0  0  8  0  0  0  0  0  0  0  0  0  0  0  0  0  0  19 0  0  0  0  0  0  0
 0  0  0  0  0  8  0  0  0  0  0  0  0  0  0  0  0  0  0  0  19 0  0  0  0  0  0  0
 0  10 0  11 0  8  0  0  0  0  0  18 0  0  0  0  0  0  0  0  19 0  0  14 0  0  0  0
 1  1  1  1  1  1  1  1  1  1  1  1  1  1  1  1  1  1  1  1  1  1  1  1  1  1  1  1
 1  1  1  1  1  1  1  1  1  1  1  1  1  1  1  1  1  1  1  1  1  1  1  1  1  1  1  1