 0  0  0  0  0  0  0  0  0  0  0  0  0  0  0  0  0  0  0  0  0  0  0  0  0  0  0  0
 0  0  0  0  0  0  0  0  0  0  0  0  0  0  0  0  0  0  0  0  0  0  0  0  0  0  0  0
 0  0  0  0  0  0  0  0  0  0  0  0  0  0  0  0  0  0  0  0  0  0  0  0  0  0  0  0
 0  0  0  0  0  0  0  0  0  0  0  0  0  0  0  0  0  0  0  0  0  0  0  0  0  0  0  0
 0  0  0  0  0  0  0  0  0  0  0  0  0  0  0  0  0  0  0  0  0  0  0  0  0  0  0  0
 0  0  0  0  0  0  0 13 16  0  0  0 12  0  0  0  0  0  0  0  0  0  0  0  0  0  0  0
 0  0  0 14  0  0  0  1  1  1  1  1  1  0  0  1  1  1  1  0  0  0  0  0  0  0  0  0
 0  0  1  1  1  0  0  0  0  0  0  0  0  0  0  0  0  0  0  0  0  1  1  1  0  0  0  0
 0  0  0  0  0  0  0  0  0  0  8  1  0  0  0  0  0  0  0  0  0  0  0  0  0  0  1  1
 0  0  0  0  0  0  0  0  0  0  8  1  1  5  4  0  0  0  0  0  0  0  0  0  0  0  0  0
 0  0  0  0  0  0  0  0  0  0  8  0  1  1  1  6  6  6  1  1  1  1  1  1  6  6  6  6
 0  0  0  0  0  0  0  0  0  0  8  0  0  0  1  6  6  6  1  0  0  0  0  1  6  6  6  6
 0  0 10 11  0  0  0  0  0  0  8  0  0  0  0  6  6  6  0  0  0 14  0  0  6  6  6  6
 1  1  1  1  1  1 20 20 20  1  1  1  1  1  1  1  1  1  1  1  1  1  1  1  1  1  1  1
 1  1  1  1  1  1  0  0  0  1  1  1  1  1  1  1  1  1  1  1  1  1  1  1  1  1  1  1
 1  1  1  1  1  1  0  0  0  1  1  1  1  1  1  1  1  1  1  1  1  1  1  1  1  1  1  1