 0  0  0  0  0  0  0  0  0  0  0  0  0  0  0  0  0  0  0  0  0  0  0  0  0  0  0  0
 0  0  0  0  0  0  0  0  0  0  0  0  0  0  0  0  0 16  0  0  0  0  0  0  0  0  0  0
 0  0  0  0  0  0  0 12  0  0  0  0  6  6  6  6  6  6  0  0  0  0  0  0  0  0  0  0
 0  0  0  0  0  0  6  6  6  0  0  0  0  0  0  0  0  0  0  0 15  0  0  0  0  0  0  0
 0  0  0  0  0  0  0  0  0  0  0  0  0  0  0  0  0  0  0  0  0  0  0  0  0  0  0  0
 0  0  0  0  0  0  0  0  0  0  0  0  0  0  0  0  0  0  0  0  0  0  0  0  0  0  0  0
 0  0  0  0  0  0  0  0  0  0  7  7  7  7  0  0  0  0  0  0  0  0  0  0  0  0  0  0
 0  0  0  0  0  0  0  0  0  0  0  0  0  0  0  0  0  0  0  0  0  0  0  0  0  0  0  0
 0 14  0  0  0  0  0 16  0  0  0  0  0  0  0  0  0 12  0  0  0  0  0  0  0  0  0  0
 7  7  7  7  7  0  6  6  6  0  0  0  0  0  0  7  7  6  8  6  0  0  0  0  0  0  0  0
 7  7  7  7  7  6  6  6  6  0  0  0  0  0  0  0  0  0  8  0  0  0  0  0  0  0  0  0
 0  0  0  0  0  0  0  0  0  0  0  0  0  0  0  0  0  0  8  0  0  0  0  0  0  0  0  0
 0  0  0  0  0  0  0  0  0  0  0  0  0  0  0  0  0  0  8  0  0  0  0  0  0  0  0  0
11 10  0  0  0  0  0  0  0  0  0  0  0  0  0  0  0  0  8  0  0  0  0  0  0  0  0  0
 6  6  6  6  0  0  7  7  7  7  7  7  7  7  7  7  0  0  6  6  0  0  0  0  0  0  0  0
 6  6  6  6  6  6  7  7  7  7  0  0  7  7  7  7  0  0  6  6  0  0  0  0  0  0  0  0