0  0  0  0  0  0  0  0  0  0  0  0  0  0  0  0  0  0  0  0  0  0  0  0  0  0  0  0
0  0  0  0  0  0  0  0  0  0  0  0  0  0  0  0  0  0  0  0  0  0  0  0  0  0  0  0
0  0  0  0  0  0  1  1  1  1  1  1  1  0  1  1  1  1  1  1  1  0  0  0  0  0  0  0
0  0  0  0  0  0  0  0  0  0  0  0  0  0  0  0  0  0  0  0  0  0  0  0  0  0  0  0
0  0  1  1  1  0  0  0  0  0  0  0  0  0  0  0  0  0  0  0  0  0  0  1  1  1  0  0
0  0  0  0  0  0  0  1  6  5  0  0  0  0  0  0  0  3  4  1  1  0  0  0  0  0  0  0
0  0  0  0  0  0  0  2  2  2  6  5  0  0  0  3  4  2  2  2  2  0  0  0  0  0  0  0
0  0  0  0  0  0  0  0  0  2  2  2  1  0  1  2  2  2  2  0  0  0  0  0  0  0  0  0
0  0  0  0  0  0  0  0  0  0  0  0  0  0  0  0  0  0  0  0  0  0  0  0  0  0  0  0
1  1  0  1  1  1  1  1  0  0  0  0  0  0  0  0  0  0  0  0  1  1  1  1  1  0  1  1
0  0  0  0  0  0  0  0  0  0  0  0  0  0  0  0  0  0  0  0  0  0  0  0  0  0  0  0
0  0  0  0  0  0  0  0  0  0  0  0  0  0  0  0  0  0  0  0  0  0  0  0  0  0  0  0
0  0  0  0  0  0  0  0  0  0  0  3  4  1  1  6  5  0  0  0  0  0  0  0  0  0  0  0
0  0  0  0  0  0  0  0  0  3  4  2  2  2  2  2  2  6  5  0  0  0  0  0  0  0  0  0
0  1  1  1  1  0  0  0  0  2  2  2  2  2  2  2  2  2  2  0  0  0  0  1  1  1  1  0
0  2  2  2  2  0  0  0  0  2  2  2  2  2  2  2  2  2  2  0  0  0  0  2  2  2  2  0